TestMap 30 30
W	W	W	W	W	W	W	W	W	W	W	W	W	W	W	W	W	W	W	W	W	W	W	W	W	W	W	W	W	W
W	P	P	P	P	P	P	P	P	P	P	P	P	P	P	P	P	P	P	W	W	W	W	W	W	W	W	W	W	W
W	P	W	P	P	P	P	P	P	P	P	P	P	P	P	P	P	P	P	W	W	W	W	W	W	W	W	W	W	W
W	P	P	P	P	P	P	P	P	P	P_N	P	P	P	P	P	P	P	P	W	W	W	W	W	W	W	W	W	W	W
W	P	P	P	P	P	P	P	P	P	P	P	P	P_PY	P	P	P	P	P	W	W	W	W	W	W	W	W	W	W	W
W	P	P	L	L	L	P	P	P	P	P	P	P	P	P	P	P	P	P	W	W	W	P	W	W	W	W	W	W	W
W	P	P	L	L	L	P	W	W	W	P	P	P	P	P	P	P	P	P	W	W	W	P	P	P	P	W	W	W	W
W	P	P	L	L	L	P	P	P	W	P	P	P	P	P	P	P_IB	P	P	W	W	W	P	W	W	W	W	W	W	W
W	P	P	P	P	P	P	P	P	W	P	P	P	P	P	P	P	P	P	D	P	P	P	W	W	W	W	W	W	W
W	P	P	P	P	P	P	P	P	P	P	P_N	P	P	P	P	P	P	P	W	W	W	P	W	W	W	W	W	W	W
W	P	P	P	P	P	P	P	P	W	P	P	P	P	P	P	P	P	P	W	W	W	P	P	P	P	W	W	W	W
W	P	P	P	P	P	P	P	P	P	P	P	P	P	P	P	P	P	P	W	W	W	W	P	W	W	W	W	W	W
W	P	P	P	P	P	P	P	P	P	P	P	P	P	P	P	P	P	P	W	W	W	W	P	W	W	W	W	W	W
W	P	P	P	P	P	P	P	P	P	P	P	P	P	P	P	L	P	P	W	W	W	W	P	P	W	W	W	W	W
W	P	P	P	P	P	P	P	P	P	P	P	P	P	P	P	P	P	P	W	W	W	W	W	W	W	W	W	W	W
W	P	P	P	P	P	P	P	P	P	P	P	L	P	P	P	P	P	P	W	W	W	W	W	W	W	W	W	W	W
W	P	P	P	P	P	P	P	P	P	P	L	P	P	P	P	P	P	P	W	W	W	W	W	W	W	W	W	W	W
W	P	P	P	P	P	P	P	L	P	P	P	P	P	P	P	P	P	P	W	W	W	W	W	W	W	W	W	W	W
W	P	P	P	P	P	P	P	P	P	P	P	P	P	P	P	P	P	P	W	W	W	W	W	W	W	W	W	W	W
W	W	W	P	W	W	W	W	W	W	W	W	P	W	W	W	W	W	W	W	W	W	W	W	W	W	W	W	W	W
W	P	P	P	P	P	P	P	P	P	P	P	P	P	P	P	P	P	P	W	W	W	W	W	W	W	W	W	W	W
W	P	P	P	P	P	P	P	P	P	P	P	P	P	P	P	P	P	P	W	W	W	W	W	W	W	W	W	W	W
W	P	P	P	P	P	P	P	P	P	P	P	P	P	P	P	P	P	P	W	W	W	W	W	W	W	W	W	W	W
W	P	P	P	P	P	P	P	P	P	P	P	P	P	P	P	P	P	P	W	W	W	W	W	W	W	W	W	W	W
W	P	P	P	P	P	P	P	P	P	P	P	P	P	P	P	P	P	P	W	W	W	W	W	W	W	W	W	W	W
W	P	P	P	P	P	P	P	P	P	P	P	P	P	P	P	P	P	P	W	W	W	W	W	W	W	W	W	W	W
W	P	P	P	P	P	P	P	P	P	P	P	P	P	P	P	P	P	P	W	W	W	W	W	W	W	W	W	W	W
W	P	P	P	P	P	P	P	P	P	P	P	P	P	P	P	P	P	P	W	W	W	W	W	W	W	W	W	W	W
W	P	P	P	P	P	P	P	P	P	P	P	P	P	P	P	P	P	P	W	W	W	W	W	W	W	W	W	W	W
W	W	W	W	W	W	W	W	W	W	W	W	W	W	W	W	W	W	W	W	W	W	W	W	W	W	W	W	W	W
