TestMap 20 20
W	W	W	W	W	W	W	W	W	W	W	W	W	W	W	W	W	W	W	W
W	P	P	P	P	P	P	P	P	P	P	P	P	P	P	P	P	P	P_PY	W
W	P	P	P	P	P	P	P	P	P	P	P	P	P	P	P	P	P	P	W
W	P	P	P	P	P	P	P	P	P	P	P	P	P	P	P	P	P	P	W
W	P	P	P	P	P	P	P	P	P	P	P	P	P	P	P	P	P	P	W
W	P	P	P	P	P	P	P	P	P	P	P	P	P	P	P	P	P	P	W
W	P	P	P	P	P	P	P	P	P	P	P	P	P	P	P	P	P	P	W
W	P	P	P	P	P	P	P	P	P	P	P	P	P	P	P	P	P	P	W
W	P	P	P	P	P	P	P	P	P	P	P	P	P	P	P	P	P	P	W
W	P	P	P	P	P	P	P	P	P	P	P	P	P	P	P	P	P	P	W
W	P	P	P	P	P	P	P	P	P	P	P	P	P	P	P	P	P	P	W
W	P	P	P	P	P	P	P	P	P	P	P	P	P	P	P	P	P	P	W
W	P	P	P	P	P	P	P	P	P	P	P	P	P	P	P	P	P	P	W
W	P	P	P	P	P	P	P	P	P	P	P	P	P	P	P	P	P	P	W
W	P	P	P	P	P	P	P	P	P	P	P	P	P	P	P	P	P	P	W
W	P	P	P	P	P	P	P	P	P	P	P	P	P	P	P	P	P	P	W
W	P	P	P	P	P	P	P	P	P	P	P	P	P	P	P	P	P	P	W
W	P	P	P	P	P	P	P	P	P	P	P	P	P	P	P	P	P	P	W
W	P	P	P	P	P	P	P	P	P	P	P	P	P	P	P	P	P	P	W
W	W	W	W	W	W	W	W	W	W	W	W	W	W	W	W	W	W	W	W